*********************************************************************
    *         *           *     *     *     *       *               *
*** *** ***** * ***** *** * * * * ***** * * *** *** * ********* *** *
* *     *   * * *     * * * * *   *     * *     * * *     *   *   * *
* ******* * * *** ***** * * * ***** ***** ******* * ***** * * *** ***
*       * * *   * *     * * *       *   * * *     *   *   * *   *   *
* *** * *** *** * * * *** * ********* * * * * * * *** * *** *** * * *
* *   *       *   * * *   * *       * *   *   * *   * * *   *   * * *
* * ********* ******* * *** *** *** * ********* * *** * * *** ***** *
* * *       * *       *   *     *   * *       * * *   * *   *       *
* * * *** *** * * ******* *********** *** *** * * * ******* ******* *
* * *   *     * *       * *           *   *     * * *       *       *
* * * ******* * ***** * * * *********** ********* * *** ***** *******
* * * *     * * *   * * *   *         *       * * *     *   *   *   *
*** * * *** *** * * * *************** * ***** * * ******* * *** * * *
*   * * * * *   * * *           *     *   *   *     *     *   *   * *
* ***** * * * ***** ***** ***** * ***** *** * ***** ***** ********* *
* *   *   *   *   * *   * *       *     *   * *   *       *       * *
* * * *** ***** * * * * * ********* ***** *** * * ******* * *** *** *
*   *   * *     * *   * *     *   * * *   *   * * *       * * *     *
***** *** * * *** ***** ***** * * * * * *** *** * ***** *** * *******
*     *   * * * *     *     *   *   * *   * *   * *   *   * *       *
* ***** ***** * ***** *** * ********* *** *** *** * * ***** ******* *
*             *           *             *       *   *               *
*********************** *********************************************
